********B****M***************B*******N********B*****B***********B***M*************************B***N************B*******************BSB***M*********BBB**********BMMMMM**B*******BNNNNN*************B**********B*****************BBBBB************BBBBBBB***M***BBB**B********B**BBM**B***B***B****B*******N*B****B*B*****B***********B***M********BBBB*************B***N************B*******************BSB***M*********BBB**********BMMMMM**B*******BNNNNN***B*********B**********B*****************BBBBB************BBBBBBB***M***BBB**B************R****R**********B**********************BBBBBBBB************B**********BBBB***Z************BBB****BBBBBB***MMMMBBBB*********************RR********BS*************ZNZNZ******BBBBBBBBBBBBBBBBBBBB***Z******NN***********                                                                                                                                                        
*************M****************B****************B**S*B******R****B*********N***********N*******B***M****B*******B******BBBBBBBBBB***B*B*************B*B****R*****B*******N*******B************M*****B**********B*S*B*************B*******B********B*MNNM****M***BBB**B********B***BM**B***B***B*****B*******B*****B**B**S*B******R****B*********N**BMMB*****N*******B***M****B*******B******BBBBBBBBBB***B*B*************B*B****R*****B*******N*******B********B***M*****B**********B*S*B*************B*******B********B*MNNM****M***BBB**B************R***R***********B**********R****ZZ****B*****S**B********M***B******N**********Z*S*********N*B*****BBBBB***MMMMBBBB*********************RR*********BBB*******P***B*B*B******P********S**************Z*******MM*********
*************M*******M*********B***********M****B***************B*****************************B********B*******B****BBB********B***B*BBBBBBBBBB****BSB**********B*******B*******M***************N**B**********B***B**********N**B*M*****B*****ZZZB*********M*****B**B********B***BM**B***BM**B******B*****B******B***B***************B************B**B*************B********B*Z*****B****BBB********B***B*BBBBBBBBBB****BSB**********B*******B*******M********B******N**B**********B***B**********N**B*M*****B*****ZZZB*********M*****B**B*************RRR**********************R****M*****B***BBBB***BBB***B******B*****N***********Z*PP*******N********BBBBBBBBBBBBBBBBBBBBBBBBBB**********RR******************P*****B*B********P***PPPPPPPPP***********Z********NN*******
****M********************N***********************BBBB***********B***N******M*****Z************BB****M**B*Z*****B********BBBBB**B***B**********B****B*B**********M*******B*******B******************B**********BBBBB*************BBBBBB**BBN******B*********B**B**B**B****M***B***B***B***B***BN****B*****B****B*MB****BBBB***********B***N******M****BZ************BB****M**B*******B********BBBBB**B***B**********B****B*B**********M*******B*******B********B*********B**********BBBBB*************BBBBBB**BBN******B*********B**B**B**B*********************Z**S************R*****M****B***B****B*******B********R****N**********************N****M*****************************MMMM******RR****M************P******************************************ZB*BBBBBBBB******
************N*********M**************************************M**B************************Z***********M*B**************BBBB**BB*B***B*BBBBBBBB*B****B*B**********BMMM****B***z***BNNN*******************R********M****N**********R***B***BB*M*****B*********B**B**B**B********B***N***B***B*M*B****B*****B*****BBBB****************M**B***************B********Z***********M*B**************BBBB**BB*B***B*BBBBBBBB*B****B*B**********BMMM****B***z***BNNN*****B*************R********M****N**********R***B***BB*M*****B*********B**B**B**B*********************Z**************R******N*******B******B*****B*********R***********ZRZ*************N****MM****************************MMMM******RR****S**BBBBBBN**PPP**********************************************************
*********************************R*****************R******BBBBBBB*****************************BB*M*Z**MB*******B*************B*B***B*B******B*B****B*B*******Z**B*******B*******M*****************ZB****************************R*******BBBB*****B*********B**B**B**B**********B***B***B***B***B******R*****************R******BBBBBBB***************M*************BB*M*Z**MB*******B*************B*B***B*B******B*B****B*B*******Z**B*******B*******M********B********ZB****************************R*******BBBB*****B*********B**B**B**B*************RRRR******************R*******N******B********BBBBB**********R***********R***************N****M****BBBBBBBBBBBBBBBBBBBBBBBBB**********RR****M************P**********************M*NNN*M************N*PP**************
********************R***********B*****M********R**************************B*********M*********B***M**M*B*******B*************B*BBBBB*B******B*BBBBBB*BBBB*******M*****Z*N*******B***************R**B************BBB***BBBB******B*******BBBBB**************B**B****************B***B***B*R*B***B*****B*****M********R**************************B*****B***M*********B***M**M*B*******B*************B*BBBBB*B******B*BBBBBB*BBBB*******M*****Z*N*******B********M******R**B************BBB***BBBB******B*******BBBBB**************B**B******************R****R**********NN****R******************************************BB**Z********************N********BBBB***MMMMBBBB*********************RR******************P*****B*B********P***Z*Z***Z*Z*************N*PP************
*******Z***********************B********Z*********************************B*******************B*****M**B***B*****************B*******B******B*******************B*******B*******B*************S****B******Z*****B******S*B**************BBBBBB****R********B*SB**B**B*******Z**B***B***B***B***B****B*****Z*ZZ*********************************B*****B*************B*****M**B***B*****************B*******B******B*******************B*******B*******B********B****S****B******Z*****B******S*B**************BBBBBB****R********B*SB**B**B************R*****R******MMMBB***BS******************N*N**************Z***S******Z********************N*B*****BBBBB***MMMMBBBB******************************************P***B*B*B******P****************MMM*********N*PP**********
******************************B***S******************Z************Z*******BBBBBBB*****Z*******B*S****MNB**MB*N*B*************BBBBBBBBB******BBBBBBBBBBBBBBB*****BMMMMM**BBBBBBB*BNNNNN*************B************BBBBBBBBBB******B*Z*****BBBBBBBBBBBB*******BBBBMMB*ZB**********B***B***B***B***B***B***S*ZMMMMZ***********Z************Z*******BBBBBBB*****Z*******B*S****MNB**MB*N*B*************BBBBBBBBB******BBBBBBBBBBBBBBB*****BMMMMM**BBBBBBB*BNNNNN***B*********B************BBBBBBBBBB******B*Z*****BBBBBBBBBBBB*******BBBBMMB*ZB************R******R*****RR*****R************************************Z***********Z******BB*M*BB*******BBB****BBBBBB***MMMMBBBB*********************************ZZZ**********MMMMM******BBBBBBBBBBBBBBBBBBBB***********N*PP********