***B***R**B***B***R**B***B***R**B***B***R**B***B***R**B***B***R**B***B***R**B***B***R**B***B***R**B***B***R**B***B***R**B***B***R**B***B***R**B***B***R**B***B***R**B***B***R**B***B***R**B***B***R**B***B***R**B***B***R**B***B***R**B***B***R**B***B***R**B***B***R**B***B***R**B***B***R**B***B***R**B***B***R**B***B***R**B***B***R**B***B***R**B***B***R**B***B***R**B***B***R**B***B***R**B***B***R**B***B***R**B***B***R**B***B***R**B***B***R**B***B***R**B***B***R**B***B***R**B***B***R**B***B***R**B***B***R**B***B***R**B***B***R**B***B***R**B***B***R**B***B***R**B***B***R**B***B***R**B***B***R**B***B***R**B***B***R**B***B***R**B***B***R**B
****B***R**B***B***SR**B***ZB***R**B***B***R**B***B***R**B***B***R**B***B***R**B***B***R**B***B***R**B***B***R**B***B***R**B***B***R**B***B***R**B***B***R**B***B***R**B***B***R**B***B***R**B***B***R**B***B***R**B***B***R**B***B***R**B***B***R**B***B***R**B***B***R**B***B***R**B***B***R**B***B***R**B***B***R**B***B***R**B***B***R**B***B***R**B***B***R**B***B***R**B***B***R**B***B***R**B***B***R**B***B***R**B***B***R**B***B***R**B***B***R**B***B***R**B***B***R**B***B***R**B***B***R**B***B***R**B***B***R**B***B***R**B***B***R**B***B***R**B***B***R**B***B***R**B***B***R**B***B***R**B***B***R**B***B***R**B***B***R**B***B***R**B***B***R**
***B***ZR**SB***B***R**B***B***R**B***B***R**B***B***SR**B***B***R**B***B***R**B***B***R**B***B***R**B***B***R**B***B***R**B***B***R**B***B***R**B***B***R**B***B***R**B***B***R**B***B***R**B***B***R**B***B***R**B***B***R**B***B***R**B***B***R**B***B***R**B***B***R**B***B***R**B***B***R**B***B***R**B***B***R**B***B***R**B***B***R**B***B***R**B***B***R**B***B***R**B***B***R**B***B***R**B***B***R**B***B***R**B***B***R**B***B***R**B***B***R**B***B***R**B***B***R**B***B***R**B***B***R**B***B***R**B***B***R**B***B****R**B***B***R**B***B***R**B***B***R**B***B***R**B***B***R**B***B***R**B***B***R**B***B***R**B***B***R**B***B***R**B***B***R**
*******Z*Z********ZZ***************ZZ*Z*********M***************************************************************************************************************************************************************************************************************************************************************************************************************************************************************************************************************************************************************************************************************************************************************************************************************
***B***R**B***B***SR*Z*B***B***R**B***SB***R**B***B***R**B***B***R**B***B***R**B***B***R**B***B***R**B***B***R**B***B***R**B***B***R**B***B***R**B***B***R**B***B***R**B***B***R**B***B***R**B***B***R**B***B***R**B***B***R**B***B***R**B***B***R**B***B***R**B***B***R**B***B***R**B***B***R**B***B***R**B***B***R**B***B***R**B***B***R**B***B***R**B***B***R**B***B***R**B***B***R**B***B***R**B***B***R**B***B***R**B***B***R**B***B***R**B***B***R**B***B***R**B***B***R**B***B***R**B***B***R**B***B***R**B***B***R**B***B***R**B***B***R**B***B***R**B***B***R**B***B***R**B***B***R**B***B***R**B***B***R**B***B***R**B***B***R**B***B***R**B***B***R**B
****B***R**B***B***R**B***B***R**B***B***R**B***B***R**B***B***R**B***B***R**B***B***R**B***B***R**B***B***R**B***B***R**B***B***R**B***B***R**B***B***R**B***B***R**B***B***R**B***B***R**B***B***R**B***B***R**B***B***R**B***B***R**B***B***R**B***B***R**B***B***R**B***B***R**B***B***R**B***B***R**B***B***R**B***B***R**B***B***R**B***B***R**B***B***R**B***B***R**B***B***R**B***B***R**B***B***R**B***B***R**B***B***R**B***B***R**B***B***R**B***B***R**B***B***R**B***B***R**B***B***R**B***B***R**B***B***R**B***B***R**B***B***R**B***B***R**B***B***R**B***B***R**B***B***R**B***B***R**B***B***R**B***B***R**B***B***R**B***B***R**B***B***R**
****B***R**BS***B***R**B***B*Z**R**B***B***R**B***B***SR**B***BZ***R**B***B***R**B***B***R**B***B***R**B***B***R**B***B***R**B***B***R**B***B***R**B***B***R**B***B***R**B***B***R**B***B***R**B***B***R**B***B***R**B***B***R**B***B***R**B***B***R**B***B***R**B***B***R**B***B***R**B***B***R**B***B***R**B***B***R**B***B***R**B***B***R**B***B***R**B***B***R**B***B***R**B***B***R**B***B***R**B***B***R**B***B***R**B***B***R**B***B***R**B***B***R**B***B***R**B***B***R**B***B***R**B***B***R**B***B***R**B***B***R**B***B***R**B***B***R**B***B***R**B***B***R**B***B***R**B***B***R**B***B***R**B***B***R**B***B***R**B***B***R**B***B***R**B***B***R**
***B***R**B***B**S*R**B***B***R**B**Z*B***ZR**B***B***R**B***B***R**B***B***R**B***B***R**B***B***R**B***B***R**B***B***R**B***B***R**B***B***R**B***B***R**B***B***R**B***B***R**B***B***R**B***B***R**B***B***R**B***B***R**B***B***R**B***B***R**B***B***R**B***B***R**B***B***R**B***B***R**B***B***R**B***B***R**B***B***R**B***B***R**B***B***R**B***B***R**B***B***R**B***B***R**B***B***R**B***B***R**B***B***R**B***B***R**B***B***R**B***B***R**B***B***R**B***B***R**B***B***R**B***B***R**B***B***R**B***B***R**B***B***R**B***B***R**B***B***R**B***B***R**B***B***R**B***B***R**B***B***R**B***B***R**B***B***R**B***B***R**B***B***R**B***B***R**B
****B***R**B***B***R**B***B***R**B***B***R**B***B***R**B***B***R**B***B***R**B***B***R**B***B***R**B***B***R**B***B***R**B***B***R**B***B***R**B***B***R**B***B***R**B***B***R**B***B***R**B***B***R**B***B***R**B***B***R**B***B***R**B***B***R**B***B***R**B***B***R**B***B***R**B***B***R**B***B***R**B***B***R**B***B***R**B***B***R**B***B***R**B***B***R**B***B***R**B***B***R**B***B***R**B***B***R**B***B***R**B***B***R**B***B***R**B***B***R**B***B***R**B***B***R**B***B***R**B***B***R**B***B***R**B***B***R**B***B***R**B***B***R**B***B***R**B***B***R**B***B***R**B***B***R**B***B***R**B***B***R**B***B***R**B***B***R**B***B***R**B***B***R**
***B***R**SB***B***R**B***B***R**B***B***R**B***B***R**B***B***R**B***B***R**B***B***R**B***B***R**B***B***R**B***B***R**B***B***R**B***B***R**B***B***R**B***B***R**B***B***R**B***B***R**B***B***R**B***B***R**B***B***R**B***B***R**B***B***R**B***B***R**B***B***R**B***B***R**B***B***R**B***B***R**B***B***R**B***B***R**B***B***R**B***B***R**B***B***R**B***B***R**B***B***R**B***B***R**B***B***R**B***B***R**B***B***R**B***B***R**B***B***R**B***B***R**B***B***R**B***B***R**B***B***R**B***B***R**B***B***R**B***B****R**B***B***R**B***B***R**B***B***R**B***B***R**B***B***R**B***B***R**B***B***R**B***B***R**B***B***R**B***B***R**B***B***R**
*******Z*********Z***************ZZ******Z****M***************Z************************************************************************************************************************************************************************************************************************************************************************************************************************************************************************************************************************************************************************************************************************************************************************************************
***B***R**B***B***R**B***B***R**B***B***R**B***B***R**B***B***R**B***B***R**B***B***R**B***B***R**B***B***R**B***B***R**B***B***R**B***B***R**B***B***R**B***B***R**B***B***R**B***B***R**B***B***R**B***B***R**B***B***R**B***B***R**B***B***R**B***B***R**B***B***R**B***B***R**B***B***R**B***B***R**B***B***R**B***B***R**B***B***R**B***B***R**B***B***R**B***B***R**B***B***R**B***B***R**B***B***R**B***B***R**B***B***R**B***B***R**B***B***R**B***B***R**B***B***R**B***B***R**B***B***R**B***B***R**B***B***R**B***B***R**B***B***R**B***B***R**B***B***R**B***B***R**B***B***R**B***B***R**B***B***R**B***B***R**B***B***R**B***B***R**B***B***R**B
****B***R**B***B***R**B***B***R**B***B***R**B***B***R**B***B***R**B***B***R**B***B***R**B***B***R**B***B***R**B***B***R**B***B***R**B***B***R**B***B***R**B***B***R**B***B***R**B***B***R**B***B***R**B***B***R**B***B***R**B***B***R**B***B***R**B***B***R**B***B***R**B***B***R**B***B***R**B***B***R**B***B***R**B***B***R**B***B***R**B***B***R**B***B***R**B***B***R**B***B***R**B***B***R**B***B***R**B***B***R**B***B***R**B***B***R**B***B***R**B***B***R**B***B***R**B***B***R**B***B***R**B***B***R**B***B***R**B***B***R**B***B***R**B***B***R**B***B***R**B***B***R**B***B***R**B***B***R**B***B***R**B***B***R**B***B***R**B***B***R**B***B***R**
****B***R**B***B***R**B***B***R**B***B***R**B***B***R**B***B***R**B***B***R**B***B***R**B***B***R**B***B***R**B***B***R**B***B***R**B***B***R**B***B***R**B***B***R**B***B***R**B***B***R**B***B***R**B***B***R**B***B***R**B***B***R**B***B***R**B***B***R**B***B***R**B***B***R**B***B***R**B***B***R**B***B***R**B***B***R**B***B***R**B***B***R**B***B***R**B***B***R**B***B***R**B***B***R**B***B***R**B***B***R**B***B***R**B***B***R**B***B***R**B***B***R**B***B***R**B***B***R**B***B***R**B***B***R**B***B***R**B***B***R**B***B***R**B***B***R**B***B***R**B***B***R**B***B***R**B***B***R**B***B
***B***R**B***B***R**B***B***R**B***B***R**B***B***R**B***B***R**B***B***R**B***B***R**B***B***R**B***B***R**B***B***R**B***B***R**B***B***R**B***B***R**B***B***R**B***B***R**B***B***R**B***B***R**B***B***R**B***B***R**B***B***R**B***B***R**B***B***R**B***B***R**B***B***R**B***B***R**B***B***R**B***B***R**B***B***R**B***B***R**B***B***R**B***B***R**B***B***R**B***B***R**B***B***R**B***B***R**B***B***R**B***B***R**B***B***R**B***B***R**B***B***R**B***B***R**B***B***R**B***B***R**B***B***R**B***B***R**B***B***R**B***B***R**B***B***R**B***B***R**B***B***R**B***B***R**B***B***R**B***B***R**B***B***R**B***B***R**B***B***R**B***B***R**B
****B***R**B***B***R**B***B***R**B***B***R**B***B***R**B***B***R**B***B***R**B***B***R**B***B***R**B***B***R**B***B***R**B***B***R**B***B***R**B***B***R**B***B***R**B***B***R**B***B***R**B***B***R**B***B***R**B***B***R**B***B***R**B***B***R**B***B***R**B***B***R**B***B***R**B***B***R**B***B***R**B***B***R**B***B***R**B***B***R**B***B***R**B***B***R**B***B***R**B***B***R**B***B***R**B***B***R**B***B***R**B***B***R**B***B***R**B***B***R**B***B***R**B***B***R**B***B***R**B***B***R**B***B***R**B***B***R**B***B***R**B***B***R**B***B***R**B***B***R**B***B***R**B***B***R**B***B***R**B***B***R**B***B***R**B***B***R**B***B***R**B***B***R**
***B***R**B***B***R**B***B***R**B***B***R**B***B***R**B***B***R**B***B***R**B***B***R**B***B***R**B***B***R**B***B***R**B***B***R**B***B***R**B***B***R**B***B***R**B***B***R**B***B***R**B***B***R**B***B***R**B***B***R**B***B***R**B***B***R**B***B***R**B***B***R**B***B***R**B***B***R**B***B***R**B***B***R**B***B***R**B***B***R**B***B***R**B***B***R**B***B***R**B***B***R**B***B***R**B***B***R**B***B***R**B***B***R**B***B***R**B***B***R**B***B***R**B***B***R**B***B***R**B***B***R**B***B***R**B***B***R**B***B****R**B***B***R**B***B***R**B***B***R**B***B***R**B***B***R**B***B***R**B***B***R**B***B***R**B***B***R**B***B***R**B***B***R**
*******Z*********Z***************ZZ**********M***************************************************************************************************************************************************************************************************************************************************************************************************************************************************************************************************************************************************************************************************************************************************************************************************************
***B***R**B***B***R**B***B***R**B***B***R**B***B***R**B***B***R**B***B***R**B***B***R**B***B***R**B***B***R**B***B***R**B***B***R**B***B***R**B***B***R**B***B***R**B***B***R**B***B***R**B***B***R**B***B***R**B***B***R**B***B***R**B***B***R**B***B***R**B***B***R**B***B***R**B***B***R**B***B***R**B***B***R**B***B***R**B***B***R**B***B***R**B***B***R**B***B***R**B***B***R**B***B***R**B***B***R**B***B***R**B***B***R**B***B***R**B***B***R**B***B***R**B***B***R**B***B***R**B***B***R**B***B***R**B***B***R**B***B***R**B***B***R**B***B***R**B***B***R**B***B***R**B***B***R**B***B***R**B***B***R**B***B***R**B***B***R**B***B***R**B***B***R**B
****B***R**B***B***R**B***B***R**B***B***R**B***B***R**B***B***R**B***B***R**B***B***R**B***B***R**B***B***R**B***B***R**B***B***R**B***B***R**B***B***R**B***B***R**B***B***R**B***B***R**B***B***R**B***B***R**B***B***R**B***B***R**B***B***R**B***B***R**B***B***R**B***B***R**B***B***R**B***B***R**B***B***R**B***B***R**B***B***R**B***B***R**B***B***R**B***B***R**B***B***R**B***B***R**B***B***R**B***B***R**B***B***R**B***B***R**B***B***R**B***B***R**B***B***R**B***B***R**B***B***R**B***B***R**B***B***R**B***B***R**B***B***R**B***B***R**B***B***R**B***B***R**B***B***R**B***B***R**B***B***R**B***B***R**B***B***R**B***B***R**B***B***R**
****B***R**B***B***R**B***B***R**B***B***R**B***B***R**B***B***R**B***B***R**B***B***R**B***B***R**B***B***R**B***B***R**B***B***R**B***B***R**B***B***R**B***B***R**B***B***R**B***B***R**B***B***R**B***B***R**B***B***R**B***B***R**B***B***R**B***B***R**B***B***R**B***B***R**B***B***R**B***B***R**B***B***R**B***B***R**B***B***R**B***B***R**B***B***R**B***B***R**B***B***R**B***B***R**B***B***R**B***B***R**B***B***R**B***B***R**B***B***R**B***B***R**B***B***R**B***B***R**B***B***R**B***B***R**B***B***R**B***B***R**B***B***R**B***B***R**B***B***R**B***B***R**B***B***R**B***B***R**B***B